1111111111111111111111
10000000000000000P0001
1000000000000000000001
1000000000000000C00001
100000000C000000000001
1000000000000000000001
1000000000000000000001
1000000000000000C00001
100000000C000000000001
1000000000000000000001
1000000000000000000001
1000000000000000C00001
100000000C000000000001
1000000000000000000001
1000000000000000000001
1000000000000000C00001
100000000C000000000001
1000000000000000000001
1000000000000000000001
1000000000000000C00001
100000000C000000000001
1000000000000000000001
1000000000000000000001
1000000000000000C00001
100000000C000000000001
1000000000000000000001
1000000000000000000001
1000000000000000C00001
100000000C000000000001
1000000000000000000001
1000000000000000000001
1000000000000000C00001
100000000C000000000001
1000000000000000000001
1000000000000000000001
1000000000000000C00001
100000000C000000000001
1000000000000000000001
1000000000000000000001
1000000000000000C00001
100000000C000000000001
1000000000000000000001
1000000000000000000001
1000000000000000C00001
100000000C000000000001
1000000000000000000001
1000000000000000000001
1000000000000000C00001
100000000C000000000001
1000000000000000000001
1000000000000000000001
1000000000000000C00001
100000000C000000000001
1000000000000000000001
1000000000000000000001
1000000000000000C00001
100000000C000000000001
1000000000000000000001
1000000000000000000001
1000000000000000C00001
100000000C000000000001
1000000000000000000001
1000000000000000000001
1000000000000000C00001
100000000C000000000001
1000000000000000000001
1000000000000000000001
1000000000000000C00001
100000000C000000000001
1000000000000000000001
1000000000000000000001
1000000000000000C00001
100000000C000000000001
1000000000000000000001
1000000000000000000001
1000000000000000C00001
100000000C000000000001
1000000000000000000001
1000000000000000000001
1000000000000000C00001
100000000C000000000001
1000000000000000000001
1000000000000000000001
1000000000000000C00001
100000000C000000000001
1000000000000000000001
1000000000000000000001
1000000000000000C00001
100000000C000000000001
1000000000000000000001
1000000000000000000001
1000000000000000C00001
100000000C000000000001
1000000000000000000001
1000000000000000000001
1000000000000000C00001
100000000C000000000001
1000000000000000000001
1000000000000000000001
1000000000000000C00001
100000000C000000000001
1000000000000000000001
1000000000000000000001
1000000000000000C00001
100000000C000000000001
1000000000000000000001
1000000000000000000001
1000000000000000C00001
100000000C000000000001
1000000000000000000001
1000000000000000000001
1000000000000000C00001
100000000C000000000001
1000000000000000000001
1000000000000000000001
1000000000000000C00001
100000000C000000000001
1000000000000000000001
1000000000000000000001
1000000000000000C00001
100000000C000000000001
1000000000000000000001
1000000000000000000001
1000000000000000C00001
100000000C000000000001
1000000000000000000001
1000000000000000000001
1000000000000000C00001
100000000C000000000001
1000000000000000000001
1000000000000000000001
1000000000000000C00001
100000000C000000000001
1000000000000000000001
1000000000000000000001
1000000000000000C00001
100000000C000000000001
1000000000000000000001
1000000000000000000001
1000000000000000C00001
100000000C000000000001
1000000000000000000001
1000000000000000000001
1000000000000000C00001
100000000C000000000001
1000000000000000000001
1000000000000000000001
1000000000000000C00001
100000000C000000000001
1000000000000000000001
1000000000000000000001
1000000000000000C00001
100000000C000000000001
1000000000000000000001
1000000000000000000001
1000000000000000C00001
100000000C000000000001
1000000000000000000001
1000000000000000000001
1000000000000000C00001
100000000C000000000001
1000000000000000000001
1000000000000000000001
1000000000000000C00001
100000000C000000000001
1000000000000000000001
1000000000000000000001
1000000000000000C00001
100000000C000000000001
1000000000000000000001
1000000000000000000001
1000000000000000C00001
100000000C000000000001
1000000000000000000001
1000000000000000000001
1000000000000000C00001
100000000C000000000001
1000000000000000000001
1000000000000000000001
1000000000000000C00001
100000000C000000000001
1000000000000000000001
1000000000000000000001
1000000000000000C00001
100000000C000000000001
1000000000000000000001
1000000000000000000001
1000000000000000C00001
100000000C000000000001
1000000000000000000001
1000000000000000000001
1000000000000000C00001
100000000C000000000001
1000000000000000000001
1000000000E00000000001
1111111111111111111111
