111111111111111111111111111111111
1111111C111111111111P000000000001
1000C0000111000000000111111111111
10000000000000000000E111111111111
111111111111111111111111111111111
