11111111111111111
10000000P00000001
10101001000000011
10000000000000001
1E0000000000E0001
11111111111111111

