111111111111111111
1P111111111C111111
111111111111111111
11111E111111111111
111111111111111111
