1111111111111111
10000000000C0001
1000000E00000001
1111111111111111
