111111111111111111
10000000000000P11
1000C00000E000001
11111111111111111
