111111111111111
1000000000000P1
1C000000000E111
111111111111111
1
