1111111111111111111111111111111111
1C10101010101010101010101010101011
1PC1C1C1C1C1C1C1C1C1C1C1C1C1C1C101
11CCCCCCCCCCCCCCCCCCCCCCCCCCCCCC11
101C11111111C11111111111C11111C101
11CC1111111CC111111CCCCCC11111CC11
101C111111CC111111CC1111CC1111C101
11CC11111CC1111111111111CC1111CC11
101C1111CC1111111111111CC11111C101
11CC111CC11111CC111111CC111111CC11
101C11CCCCCCCCCCC1111CC1111111C101
11CC1111111111CC1111CC11111111CC11
101C1111111111CC11CCCCCCCCC111C101
11CC11111111111111111111111111CC11
101CCCCCCCCCCCCCCCCCCCCCCCCCCCC101
1101C1C1C1C1C1CEC1C1C1C1C1C1C1C101
101010101010101C101010101010101011
1111111111111111111111111111111111
