11111111111111111
10000000P00000001
10C0C00C0000000C1
10000000000000001
100000000000C0001
11111111111111111

