000000000000000000
1000000000P1111111
C00000000000000E01
111111111111111111
