1111
1P11
10C1
10E1
1A01
1111
