111111111111111111
1P010000000C111111
111111111110111111
11111E000000111111
111111111111111111
