11111111111111111
10000000P0000P001
10C0C00C0000000C1
10000000000000001
1E000000011111001
11111111111111111

